11111111111110E

EEEEEEEEEEEEEEE