1111111111111111111111
1001001001001100100101
1001111110000001100101
1000000000000000000001
1000000P00C11111111111
1111110000000000000001
1111111100111111000001
1111111100000111110001
1111010100011011E00001
1111111111111111111111