11111111
1P000001
100CC001
100000E1
11111111
