11111111111111111111111111111111111111111
10111010101010101010101010101010101011101
11010101010101010101010101010101010101011
11111111111111111111111111111111111111111
1101P000000000000000000000000000000001011
10110000000000000000000000000000000001101
11010000000000000000000000000000000001011
10110000000000000000000000000000000001101
11010000000000000000000000000000000001011
1011000000CCC000000CCCCCCCC00000000001101
110100000CCC000000CCC0000CCC0000000001011
10110000CCC000000000000CCC000000000001101
1101000CCC0CCC0000000CCC00000000000001011
101100CCC0CCC000000CCC0000000000000001101
11010CCCCCCCCCC00CCC000000000000000001011
10110000CCC00000CCC0000000000000000001101
1101000CCC00000CCCCCCCCCCC000000000001011
10110000000000000000000000000000000001101
110100000000000000000000000000000000E1011
11111111111111111111111111111111111111111
11011010101010101010101010101010101011011
10110101010101010101010101010101010101101
11111111111111111111111111111111111111111