11111111
1P0100E1
10010001
100C0001
10010C11
11111111